16021453,3,165,70,95,30
17642921,2,92,70,22,2
17642921,2,92,70,22,2
406908289,1,263,11,252,8
152389,1,15,2,13,7
390450,292,95,62,33,413
45026123,112,20,16,4,65
72315452,7,33,1,32,10
72315452,7,33,1,32,10
192179072,4,168,2,166,2
263542313,2,53,5,48,4
390972006,1,10,1,9,7
10367407,319,143,72,71,184
58753234,35,20,4,16,9
200571871,18,44,1,43,5
348472751,19,17,3,14,12
369133455,1,152,3,149,1
395437400,11,11,6,5,130
44393330,2,48,2,46,9
151148132,51,96,21,75,55
155959105,3,94,2,92,6
169366230,88,291,19,272,126
308586273,5,72,5,67,9
2376548,134,50,12,38,12
4295303,42,15,4,11,31
88151991,6,286,7,279,9
136146311,15,81,10,71,88
276363382,4,88,57,31,22
276363382,4,88,57,31,22
8596085,183,100,97,3,90
25893308,88,100,1,99,1006
35842711,1,362,13,349,216
139255511,82,43,22,21,238
197788015,11,134,44,90,32
206698889,10,47,18,29,52
246657985,1,28,3,25,110
274721946,12,4,1,3,39
306792749,3,10,9,1,90
331798330,19,10,2,8,37
18541954,3,14,2,12,7
92931533,16,62,13,49,2
126474485,1,206,8,198,1209
130735295,19,5,1,4,155
133885421,2,25,2,23,2
135509304,8,15,2,13,27
4213430,14,112,14,98,50
14545990,21,38,3,35,2
17011902,45,99,25,74,31
17323200,43,26,17,9,36
19612528,12,116,3,113,761
27210095,290,91,10,81,217
151704187,25,287,18,269,320
172917364,11,31,11,20,3
210238733,26,83,7,76,120
210511566,6,103,2,101,26
235269191,62,188,3,185,107
9310844,16,23,15,8,2
17308292,106,135,82,53,179
19084703,1,61,11,50,7
55087132,11,134,1,133,10
206006420,18,13,3,10,7
373994624,1,70,1,69,19
70909932,24,323,38,285,35
319224350,9,44,8,36,34
286092313,5,6,1,5,33
342840502,3,234,4,230,28
374190951,5,13,3,10,43
80602731,37,32,6,26,75
421098037,1,23,6,17,1
236010451,1,1008,6,1002,5
362519482,1,31,1,30,119
428655022,6,13,4,9,15
13001473,12,271,3,268,49
165545056,23,29,9,20,55
165545056,23,29,9,20,55
5129492,52,38,6,32,22
231450845,2,59,57,2,142
348226445,1,32,12,20,18
290098795,217,23,7,16,33
1770217,2,6,4,2,2
2936412,5,36,6,30,11
36184350,27,24,6,18,115
35080286,79,8,6,2,1
224296370,6,90,19,71,16
155557122,4,18,1,17,7
9603109,29,113,10,103,53
9603109,29,113,10,103,53
344941085,8,43,8,35,33
834151,5,14,8,6,16
337166486,4,8,4,4,5
370482057,6,153,3,150,23
292201997,32,29,22,7,2
5731362,1,95,5,90,1
341627788,1,35,10,25,2
341627788,1,35,10,25,2
330934912,14,18,4,14,21
3211224,58,68,6,62,82
310578883,1,13,2,11,97
30693921,1,124,21,103,1
448796,6,13,3,10,4
12931073,2,358,14,344,115
1358416,5,50,21,29,3
2014391,30,16,11,5,5
5035970,3,45,5,40,2
70461057,9,13,12,1,8
124537532,16,40,1,39,8
177191899,11,2,1,1,61
20754499,63,9,3,6,18
32940222,77,20,2,18,4
32940222,77,20,2,18,4
285497228,16,149,9,140,7
344052684,1,9,1,8,17
451758,56,73,50,23,51
134322404,4,48,2,46,42
134322404,4,48,2,46,42
187252695,3,12,1,11,3
357832317,11,17,2,15,33
5134744,12,36,10,26,7
24477796,3,24,6,18,2
110320658,10,10,2,8,7
170361461,4,45,38,7,524
281611758,3,3,1,2,1
281611758,3,3,1,2,1
343599941,16,54,49,5,16
22788997,1,21,2,19,7
10331297,19,66,6,60,53
368107,49,66,53,13,7
20800512,18,193,22,171,13
29588610,1,54,13,41,4
151045377,1,85,6,79,9
475146,18,338,134,204,1
583440,1,6,1,5,1
2992020,8,287,3,284,32
2992020,8,287,3,284,32
4208235,9,91,14,77,147
168131168,2,37,3,34,11
16475813,6,8,5,3,1
368196965,1,41,3,38,1
368196965,1,41,3,38,1
299201595,10,60,58,2,23
189497,1,61,18,43,2
154758709,1,7,1,6,16
167972152,11,35,8,27,12
167972152,11,35,8,27,12
328927671,8,39,23,16,1
5182581,1,8,4,4,9
12982578,1,35,14,21,3
168432203,13,77,25,52,20
182077,14,50,38,12,12
31623346,4,28,26,2,13
145559615,1,40,39,1,15
184959837,4,47,6,41,9
353212419,1,28,8,20,25
353212419,1,28,8,20,25
10125489,70,296,31,265,458
67844686,1,81,13,68,99
279871341,2,3,1,2,43
186825,71,93,53,40,224
126433854,3,77,2,75,3
145194781,3,18,1,17,27
145194781,3,18,1,17,27
73598659,1,56,6,50,32
120490126,1,191,5,186,35
120490126,1,191,5,186,35
239357328,2,28,2,26,5
8983351,3,42,2,40,1
54625111,4,39,10,29,5
367360538,3,86,27,59,6
1012037,8,274,94,180,38
1316853,4,34,29,5,14
12925010,1,92,15,77,8
122271729,1,548,6,542,17
341209778,1,36,15,21,30
341209778,1,36,15,21,30
215337222,87,77,54,23,17
318093580,1,24,2,22,94
349428141,4,25,9,16,4
33665713,2,19,4,15,4
353953,2,104,17,87,4
353953,2,104,17,87,4
20878014,2,10,2,8,10
65482317,1,50,43,7,24
11889593,1,31,17,14,31
169774598,22,502,20,482,265
318464095,5,39,9,30,40
357701,1,75,1,74,1
4606373,1,95,5,90,1
59112199,1,27,20,7,7
196366245,2,64,4,60,14
306228462,4,31,12,19,12
206627943,1,53,9,44,118
168485774,1,27,11,16,8
314029761,1,756,92,664,15
92702127,11,16,3,13,22
145968947,1,85,9,76,3
145968947,1,85,9,76,3
395001079,11,19,18,1,42
52372370,1,90,52,38,1
162920785,1,13,3,10,16
4818316,1,178,24,154,29
11796361,3,154,25,129,1
16611796,3,23,8,15,68
137270,1,90,24,66,3
569178,14,13,5,8,6
569178,14,13,5,8,6
353114124,1,7,3,4,5
132072526,1,315,40,275,1
51989564,1,92,2,90,1
6042984,4,69,18,51,4
160083765,5,21,2,19,9
378095864,18,20,2,18,59
6302720,1,40,4,36,1
260624563,1,460,5,455,1
255885225,2,52,2,50,28
77242045,3,113,39,74,8
77242045,3,113,39,74,8
311148,2,98,16,82,130
860985,1,30,21,9,20
860985,1,30,21,9,20
6226528,2,52,1,51,6
174644676,31,52,8,44,7
248960030,2,27,5,22,40
1323134,1,116,37,79,8
56220949,1,92,23,69,4
411045100,3,6,5,1,13
360580049,2,20,6,14,1
2016850,4,39,14,25,1
204722914,1,34,4,30,4
81029975,3,75,18,57,11
2529785,7,60,34,26,40
2529785,7,60,34,26,40
193822733,5,8,5,3,3
1920948,2,90,33,57,2
316953105,2,16,1,15,9
17524427,2,216,1,215,3
55667261,15,115,1,114,12
99444702,1,25,5,20,3
1012306,1,900,139,761,24
34446122,1,346,12,334,1
129581002,1,281,2,279,2
289792700,1,27,10,17,16
314178133,7,16,12,4,51
186260593,8,1888,16,1872,53
8963289,1,11,1,10,1
858704,1,235,92,143,60
298470827,1,83,30,53,1
40375074,4,54,10,44,2
331204976,5,8,5,3,18
5092744,1,43,7,36,2
63656203,3,98,52,46,21
326124703,4,53,1,52,2
350795553,1,33,30,3,2
937263,14,16,3,13,62
3591903,11,76,22,54,9
45790486,118,127,17,110,566
45790486,118,127,17,110,566
76113396,1,77,7,70,4
176516469,1,84,2,82,6
253292914,1,16,4,12,13
411536329,1,8,1,7,4
411536329,1,8,1,7,4
198501824,8,336,6,330,13
270779469,2,35,1,34,17
139133594,3,57,8,49,8
162166544,1,62,4,58,19
147736,10,13,5,8,18
158628917,1,20,2,18,4
158628917,1,20,2,18,4
231805511,2,63,9,54,28
1074156,1,119,11,108,11
172508802,8,17,2,15,2
502168,27,30,27,3,14
59101922,8,19,2,17,10
315404575,1,39,1,38,15
27472684,3,39,4,35,12
14407878,1,64,44,20,21
150139278,5,98,78,20,1
22662710,5,239,1,238,18
218342844,2,32,8,24,2
55280739,3,23,2,21,5
205447443,5,7,4,3,4
205447443,5,7,4,3,4
3809042,1,74,6,68,2
21099929,7,97,52,45,54
60470911,12,181,140,41,31
155097179,3,34,23,11,21
156427097,1,29,2,27,7
156427097,1,29,2,27,7
302195505,1,53,30,23,12
734115,53,96,94,2,30
1108065,3,61,24,37,59
5932908,8,900,209,691,5
116292201,2,17,1,16,1
155578833,2,83,6,77,1
206239381,1,2,1,1,1
43092,3,205,133,72,30
555339,7,32,25,7,7
904781,3,85,19,66,9
194504297,1,65,30,35,31
264779653,1,29,3,26,2
356754713,2,11,9,2,1
1414107,2,80,42,38,19
66677082,41,17,7,10,115
281243183,1,124,77,47,2
326726135,1,168,1,167,7
207515996,14,21,4,17,2
1614685,11,29,20,9,20
253518905,2,36,5,31,3
302916,4,6,2,4,12
746239,2,111,90,21,3
24212065,2,429,9,420,29
648560,1,26,3,23,6
1387906,4,32,7,25,17
1654261,1,87,12,75,6
152400646,22,481,61,420,75
65245,1,231,14,217,1
2621569,11,217,106,111,65
42959005,4,197,11,186,7
334502052,6,88,13,75,81
263109349,1,180,55,125,2
963478,2,18,1,17,8
963478,2,18,1,17,8
81773580,1,51,44,7,2
76216834,1,2,1,1,4
912736,69,54,42,12,32
325148850,1,289,1,288,1
8781232,2,180,22,158,4
193249033,1,23,1,22,3
1503492,1,61,13,48,17
2260076,2,40,10,30,9
67951037,2,7,1,6,3
9889821,1,32,4,28,16
255067973,1,27,4,23,2
68383602,5,2,1,1,19
304115057,1,62,9,53,7
164888,1,534,130,404,9
21207387,2,11,3,8,2
245969551,4,25,3,22,3
25740703,3,17,6,11,6
36436074,45,58,11,47,15
64608355,3,14,11,3,38
190345440,1,29,4,25,35
33472138,3,66,56,10,8
58980749,1,44,42,2,10
265160564,9,20,4,16,47
1235032,3,53,2,51,2
27113284,38,86,44,42,25
264819715,2,39,1,38,3
5876,17,68,40,28,4
2332126,6,21,14,7,81
4369369,11,24,2,22,18
8055867,4,38,2,36,39
150866756,11,10,8,2,6
1256580,18,93,13,80,5
168166577,3,21,1,20,3
4409225,7,50,8,42,47
46815918,6,13,9,4,6
492761,8,57,7,50,4
79909745,4,87,32,55,62
79909745,4,87,32,55,62
394864153,2,13,8,5,3
29853373,1,92,14,78,1
113546190,1,304,9,295,14
3294257,8,17,5,12,2
231260873,15,127,109,18,1
216444106,1,93,4,89,3
216444106,1,93,4,89,3
216444106,1,93,4,89,3
268514384,2,99,11,88,3
139825320,4,91,5,86,3
157312961,5,35,7,28,104
5588199,4,192,14,178,2
100032969,10,5,3,2,41
470938,2,69,19,50,5
139883401,1,80,12,68,10
141973880,1,30,29,1,4
12311188,4,83,5,78,1
29194181,14,34,1,33,2
20703184,10,61,34,27,1
151410968,6,37,16,21,14
45007168,3,65,9,56,19
147509971,95,30,22,8,234
148901975,7,523,43,480,19
211911972,4,38,20,18,7
381655843,16,7,4,3,45
315195553,1,39,5,34,9
410794147,1,18,1,17,2
214858839,32,10,7,3,34
214858839,32,10,7,3,34
160156244,1,98,2,96,3
810800,1,2,1,1,7
69861590,3,67,5,62,13
108491464,8,7,6,1,21
344254678,3,13,1,12,2
824089,3,41,9,32,17
62162731,1,179,14,165,3
177659437,5,68,6,62,3
378149325,3,19,18,1,30
2657713,5,199,8,191,20
92388084,6,35,2,33,1
211468953,1,87,14,73,1
57437721,32,67,40,27,50
57437721,32,67,40,27,50
126759222,3,9,7,2,9
154794978,1,325,4,321,6
154794978,1,325,4,321,6
237323783,2,37,16,21,5
1127978,1,32,26,6,4
